111111111111111111111
100P00C00CE0000100111
10111C11011001V000111
10C1C0V000C1110111111
1C1101001111110CCC111
1V0110C0000C000000111
110111110111111111111
110111100001110111111
11011110110000C111111
11C00110C001110001111
111111111111111111111