11111111111111
10P000C00CE011
10111C11011001
10C1C00000C111
1C110100111111
11111111111111