111111111111111111111
100P00C00CE0000100111
10111C110110010000111
10C1C00000C1110111111
1C11010V1111110CCC111
100110C0000C000000111
111111111111111111111