1111111111111111
10000100110E0001
10C0010111001011
1111010100001111
1001010000000001
10P0000001111111
1111111111111111