1111111111111111
1000C10C110E0001
1C00010111001011
1111010100001111
100101000C0000C1
10P00C0001111111
1111111111111111